19

 *************************************************************************
 *                                                                       *
 *                                                                       *
 *                                                                       *
 *                   ****                                                *
 *                                                                       *
 *                                                                       *
 *                                                                       *
 *                                                                       *
 *                                                                       *
 *                                                                       *
 *                                                                       *
 *                                                                       *
 *                                                                       *
 *                                                                       *
 *                                                                       *
 *                                                                       *
 *************************************************************************