11

 ***************************************
 *				      *
 *                                     *
 *        *                            *
 *	 *			      *
 *		************ 	      *
 *				      *
 *				      *
 *				      *
 ***************************************
